#######S######################################################
#    ## ##         ###    ############                       #
# ## ## ## ## #### ### ##           ######## ############## ##
# ## ##    ## ##   ### ## ######### # ##              ##    ##
# ## ######## ## ##### ##        #### ############### ## #####
# ##          ##    ## ### ##########                 ##     #
################### ## ### ######################### ####### #
#########           ## ###                   ## ##   # #     #
#         ######################## ####### #### #### # #  # ##
######### #########        ## # ## #     #   ## ##   # ## # ##
#                ## ###### ## # ## ## ## #       # ###    # ##
######## ########## ## ### ## # ##  # ## # # # ### ###### # ##
#                ## ## ##  ## # ### # #### # #          # # ##
# ################# ## ## ### #     #   ## # ############ # ##
#                   ## ## ###  #### ### ## # #    #       # ##
############## ####### ##  ###  ###  ## ## # #### ######### ##
##      # #            ###   ##  ### ## ## # #### #         ##
## ## # # # ################ ### # # ##    ####   # ##########
##  # # # # ###                  # # ### #   ## ###          #
### # # # # ###  ################# # ### # #### ############ #
##  # #     ###                      ### #   ##              #
###############################################E##############