######################################
########################             #
##                           ####### E
## ######### #### ###### #############
############ #### ######       #######
S            ####        ### #########
############ #########################
############                         #
######################################