#########################################
S   # #   #     #             #         #
# ### # # ##### ##### ####### # ##### ###
#   #   #       #           # # #   #   #
# # # ### ####### ########### ##### ### #
# #     # #             # # #   #     # #
# # ### # ########### # # # ### # ### # #
# # #   #   # #   # # # # #   # # # # # #
# # # ####### ### # ### # # # # # # ### #
# # # # #     # #     #   # #     # # # #
# ##### # ##### ### ##### ### ##### # # #
# #   # #   # #         # #   #   #   # #
# ### # # ### # ### ##### # ### # ### # #
#     # # # # # #   #   # # #   #     # #
# ##### # # # # ### # ### # # ######### #
# #     #     # #       # # #         # #
# ### # ##### # ####### # ### ####### # #
# #   # # # #   #     #       # #   #   #
# # ### # # # # # ############# ### ### #
# # #   #     #         #     # #     # #
# # ######### ####### ### ### # ### #####
#   #   #   # #   #   #   #     #   #   #
# ### # # # # # # ######### # ### ### # #
# # # #   # # # # #       # # #       # #
# # ### ### # # ### ### ### ##### ### # #
#       #   #   #   #   #   #       # # #
### # ####### ### ####### ### ##### # # #
# # # # #   #   # #       # #   #   # # #
# ### # ### # ### # ####### # ######### #
#     #   #     # #     # #   # #   #   #
### ##### ### ### ##### # # ### # #######
#   # # # #   #     #       # # #       #
# ### # # # ### ##### ##### # # # # # # #
# # # #       #       #   #   #   # # # #
# # # # # ##### ##### # ######### ##### #
#     # #   #   #   # # #   # # #   # # #
##### # ### # # # ##### # ### # ### # # #
#         #   # #   #   #     # # # #   #
### ##### ##### # # # # # ### # # # # ###
#   #       #     #   #     #       #   E
#########################################
